# GODS, COMBINED VARIANTS

Lemmas referring to divine names were standardized manually with some help from automated data processing. The point of 
departure was a list of  dictionary forms of divine names in our full Oracc dataset. The names with no variant spellings were left as they were. The remaining 791 divine names were standardized to 339 lemmas. To help the process of combining the lemmas, we processed lists which grouped lemmas according to strings of letters they shared. The full lists of lemmas were manually analyzed with the aid of the lists of grouped lemmas, using transliterations in the Oracc data to check if suspect lemmas actually referred to one and the same Akkadian or Sumerian word in the transliteration. When several lemmas in Oracc referred to a single Akkadian or Sumerian word, we chose the most common lemma in Oracc to represent the word and replaced all other lemmas with the most common lemma. However, different ancient names of a deity were kept distinct. For instance, the lemma Ištar was used to replace Issar and IŠTAR but not Inanna. Accordingly, the names Bēl and Marduk were not combined, although Bēl was a common byname of Marduk in antiquity.

# The preferred normalization is on the left side of the equals signs and the variants on the right side. In most cases, the preferred normalization is the most common one in our corpus. Based on json files from February 2019.



Abaralah == Abara-DUDU
Abmunzerkiʾaŋ == Abmunzerkiʾag
Abnarbu == AbnirBU
Ab.U₂ == Abu
Aginzamanuš == Aginmanuš
Alala == Alalu
Amarazu == Amaʾarazu
Amasagnudi == Amasagnudu
Amašuhalbi == Amašuḫalbi
Amaušumgalana == Amaušumgalanak
Anahiliba == Anhiliba
Anbu == Anubu
Annunitu == Annunitum,Anunitu
Antu == Antum,antum
Anu == Anum
Anunnaki == Anuna,Anunak,Anunnakkū,Anunnaki,Anunnaku,Anunnakku
Anzu == Anzud,Anzû
Apla-Adad == Apladad
Asakku == Asag
Asalluhi == Asarluhi,Asalluḫi
Asaralimnuna == Asaralimnunak
Asari == ASARI,Asare
Asu == Esu
Ašrat == Ašratu
Aštartu == Astartu
Aya == Nur

Baba == Bau,Babu,Bābu
Baliha == Balihu
Bel-agu == Bel-age
Belet == Beltu,Belat,Bēltu
Belet-Akkad == Bēlet-Agade
Belet-Arbail == Belet-Arbaʾil,Belet-Arba-il
Belet-ayyaki == Belet-Eana,Belet-ayakki
Belet-ekalli == Belat-ekallim
Belet-ili == Bēlet-ilī
Belet-Ninua == Belet-Nina
Belet-Nippur == Belet-Nippuri
Belet-parṣi == Belat-parṣi
Belet-ṣeri == Belat-ṣeri,Bēlet-ṣēri
Bel-labira == Bel-labria
Bel-ṣarbi == Bel-ṣarbat,Bel-Ṣarbati
Bel-šarri == Bel-šarru
Bel-Tarbaṣi == Bel-tarbaṣi
Beltiya == Beltia,Beletiya
Beltu-ša-Reš == Belet-ša-reši
Beltu-ša-Uruk == Belet-ša-Uruk,Belet-Uruk
Birdu == Birtu

Dagan == Dagān
Damgalnunak == Damgalnuna
Damkina == Damqina,Damkiana,Damkiʾanak
Dapar == Daparu
Dayyanu == Dayanu
Diŋirmah == Dimermah
DiŋirMartu == Diŋirmartu
Dumuduku == Dumudukug
Dumuzi == Dumuzid,Duʾuzu
Dumuzidabzuk == DumuzidAbzu,Dumuzi-Abzu,Dumuziabzu

Endašurima == Endašurimma
Enki == Enkik
Enkum == Enkummu
Enlil == Ellil,Illil
Enlilbanda == Ellilbanda
En-LU == Enlu,EnLU
Enmelulu == En.me.LU.LU
Enmešara == Enmešarra
Enšada == Enšadu
Enudtila == Enutila
Ereškigal == Ereškigala,Ereškigalak
Erragal == Errakal
Erua == Eru,Eruʾa,Aru,Arua
Ešme-karab == Išme-karab

Gašan.MAR.KI == GašanMARKI
Gašanguedena == Gašanguedina
Gašanhursaŋ == Gašanhursaŋa,Gašanhursaŋak
Gašanibizibara == Gašanibizidbara
Gašanisina == GašanIsina
Gašankatešasiga == Gašantešasiga,Gašangutešasiga
Gašantinluba == Gašantiluba
Gayau == Gayayu
Geškinti == Ŋeškiŋti
Gilgameš == Gilgāmeš
Girra == Gira,Giru,Girru
Gubagararae == Gubagarae
Gugal == Gugallu
Guhašla == Guhašlala
Gula == Meme

Ŋešbar == Ŋešbara
Ŋeštinanak == Geštinana
Ŋisaʾa == Gilsaʾa

Hadaniš == Hataniš
Hedimkug == Hedimmekug,Hedimekuga
Hendursaŋak == Hendursaŋa,Hendursag
Humhum == Humhumiya,Humhummu
Humunṣir == Humunzer

Igalimak == Igalim,Igalima
Igigi == Igigu,Igigû
Igiheŋal == Igiḫegal,Igiheŋala
Ilaba == Il-aba,Ilba
Ili-abrat == Iliabrat
Illabundu == Il-la-bunda
Illat == illat
Ilumer == Iluwer
Inanak == Inana,Inanna
Innin == Innina,Innini
Irnina == Irnini
Išar-neriššu == Išar-NEriššu
Išhara == Išhuru,Išḫara
Ištar == Issar,IŠTAR
Ištar-Kakkabi == Ištar-kakkabi,Issar-kakkibi

Kaheŋal == Kaḫegal,Kaheŋala
Kakka == Kaka
Kalamšagkušu == Kalamtašagkušu
Kanisura == Kanisurra
Kidmuru == Kidmuri
Kilidaŋala == Kilibdaŋal
Kindazid == Kindazi
KinnuSUM == Kin.nu.ŠUM₂,Kin.nu.SUM
Kisa == Kisag
Kiʾugu == AMA.KI.U₂.GU₇
Kubu == Kūbu
Kumarwi == Kumarbi
Kurašuurur == Kurašuʾurur
Kurdaru == Kurdari
Kurunam == Kurunnam
Kusibanda == Kusigbanda,Kugsigbanda
Kušu == Kūšu

Lahuratil == Lahura-BAD
Lahar == Laḫar
LamaKakka == Lammagaga,Lamma-Kakka
Lamasaga == Lammasaga
La-tarak == Latarak
Lisi == Lisin
Lugalbanda == Lugal-banda
Lugaldimerankia == Lugaldimmeranki
Lugaledinna == Lugaledina,Lugaledenak
Lugalgirizala == Lugalkirizal
Lugalgudgaz == LugalGUDGAZ
LugalGudua == Lugalgudua,Lugal-Guduʾak
Lugalheŋal == Lugalheŋala
Lugalira == Lugalerra,Lugal-Erra,Lugal-girra,Lugalirra
Lugal-KA-gina == LugalKAgina
Lugal-kisurra == Lugalkisura
Lugalamašpae == Lugalamašpaʾe
Lugal-Maradak == Lugal-Marada,Lugalmarada,Lugal-Marda
Lugalsiga == Lugal.SIG₇.a
Lugalšuana == Lugalšuanna
Lugalurak == Lugalurra
Luḫušû == Luhušu
Lulim == Lulimu
Luma == LUM-ma

Madanu == Madānu,Mandanu
Magulaʾana == Magulana
Mahdiʾanak == Mahdiana
Malik == Maliku
Mami == Mama
Mamu == Mamud
Manungal == Manugal
Manzat == Manziat
Marat-biti == Marat-Biti
Mar-biti == Mar-Biti
Marutukku == Marutukka
Mašgi == Mašŋi
Maškimluharana == Maškim-GI₆-lu-harran,Maškim.GI₆.luharana
Medimsag == Medimša
Meslamtaea == Mešlamtaea,Meslamtaʾea
Messagunug == MessaŋŋaUnuga,Mešsaŋŋaunugak,MessaŋŋaUnug,Messaŋŋa-Unug
Mišaru == Mišarum
Mudugasa == Mudugasaʾa
Muheŋala == Muhegale
Mullilzi == Mullilzid
Mullissu == Mulliltu
Muʾati == Muati
Muhra == Muḫra
Muluhursaŋa == Muluhursaŋ
MunusKIa == NunusKIa
MunusKUmea == NunusKUmea
Muru == Mur,Murum
Mušmehuš == MUŠ₂.me.huš
Muzebašeʾa == +Muzebašeʾa

Nabu == Nabû,Na,Nabium
NAGAR == Nagar
Nahunte == Nahundi
Namma == Nammu
Namraṣit == Namra-Ṣit,Namra-ṣit
Namtar == Namtaru
Nanaya == Nannaya,Nanâ,Nana
Nanibgal == Nanibal
Nanna == Nannaru,Nannar
Nannabalaŋanki == Nannabalaganki
Nannabalaŋmah == Nannabulugmahmu,Nannabulugmahŋu
Narunte == Narundi
Niggaba	== Niŋgaba
Nimgirgire == Nimŋirŋire
Ninadamkuga == NIN-adamkuga
Ninagal == Ninagalak,Ninaŋal
Ninanzud == NIN-Anzu
Ninbizeg == Ninbizem,Ninbizeŋ
Ninda == Irda
Nindara == Nindar
Nindašurima == Nindašurimma
Nindiŋirenek == Nindiŋirene
Nindukuga == Nindukugak
Nin-Eana == Nineanna,Nineana
Ninegalak == Ninegala,Ninegal
NIN-Ekura == NINekura
Ningal == Nikkal
Ninŋešzidak == Ningišzida,Ningizzida,Ninŋešzida
Ningirgilum == NinGirgilum
Ningirim == Ningirima
Ninŋirsuk == Ningirsu,Ninŋirsu,Ingirsu
Ningublaga == Ningublagak
Ninhursaŋak == Ninhursaŋ
Ninigara == Ninigarak
Ninigizibara == Ninigizidbara
Ninildum == Ninildu,Ninildumak
Niniri == NIN-iri
NIN-iribara == Niniribara
Ninirigalak == Ninirigal
Ninisinak == Ninisina,NinIsina
Ninkarnuna == Ninkarnunak
Ninkarrak == Ninkar,Ninkarak
Ninkasi == Ninkasik
Ninkašbarak == Ninkašbara
Ninkugnuna == Ninkugnunak
Ninkulkul == Šenkulkul
Ninkura == Ninkurak
Nin-LU == NinLU
Ninmada == Ninmadak
Ninmah == Ninmaḫ
Ninmarkik == Ninmarki,NinMARKI,Nin-MAR-KI
Ninmena == Ninmenna,Ninmenak
Ninmulguna == Ninmulsua
Ninnibruk == Ninnibru,NinNibru
Ninniŋinŋarak == Ninniŋara,NIN-niŋara
Ninpirig == Ninpiriŋ
Nin-SAR == NinSAR
Ninšar == Ninšara
Nin-siana == Ninsiana,Ninsianak,Ninsianna,Ninsiʾana,Ninsiʾanak
Ninsiŋarana == Ninsigarana
NINtargul == NIN-targul
Ninti == Nin.TI
Nintilmud == Nintimud
Nintinuga == Nintinugga
Nintubabbar == Ninturbabbar
Nintur == Nintu
Ninudikišara == Ninudišara
Ninudtila == Ninutila
Ninurim == Ninurimak,NinUrim
Ninurta == Ninurtak,Inurta
NIN-zu == NINzu
Ninzuʾanak == Ninzuana,Nizuana
Niŋzida == Niŋzid
Nisaba == Nisabak,Nissaba
Nitah == Nita
Nudimmud == Nudimud
Nungal == Nungalene
Nunnamnir == Nunamnir
Nunura == Nunurra
NunusAŠtumu == Nunuz-AŠ-tumu
Nuru == Nūru
Nusku == Nušku,Nuska

Pabilsag == Pabilsaŋ
Pagalguena == Pagalguenna
Palil == Pālil
Paniŋara == Panigingara,Papniŋarak,Papniŋinŋarak
Panunanki == Papnun-anki
Parisat-pale == Parišat-pale
Patindug == Padindug

Qibiya-dumqi == Qibi-dunqi
Qudma == Qudmu

Rammanu == Rammānu

Sadarnuna == Sadarnunna,Sadurahnuna,Sadaranuna
Šaganlalukarkara == Šaŋanlalukarkara
Saŋkar == Saŋkara
Saŋkud == Sakkud,Sagku
Saŋkulkul == Saŋgulgul
Šakkan == Šakan
Šala == Šāla
Ṣalam == Ṣalmu
Šalaš == Šālaš
Šarrat-Deri == Šarrat-Der
Šarrat-nipha == Šarrat-niphi
Šarrat-Nippur == Šarrat-Nippuru
Šazu == Šazi
Sebettu == Sebetti
Šegbaraimime == Šegbarimime
Šena-ilan == Šina-ilana
Šerrida == Šerida
Šeruʾa == Šerua
Šiddukišara == ŠID.DU₃.ki.šar₂.ra,Šiddukišarra,Šitadukišara
Sigsig == Sisig
Siki == Sig
Sikilamesi == Sikilamezu
Šimaliya == Šimaluʾa
Sin == Sîn
Siraš == Siris
Šitemme-pišunu == Šitemme-pīšunu,Šitemmi-pīšunu
Šulpae == Šulpaea
Šulšaganak == Šulšagana
Šuqamuna == Šuqamunu
Šuziana == Šuzianna,Šuziʾana

Tašmetu == Tašmētu
Telītum == Telitu
Teššub == Teššob
Timuʾa == Timua
Tukug == Tuku

Ubanuila == Udbanuila
Ude == Uded,Uʾe
Udeguba == Udiguba
Udgirizalana == Udkirizalana
Udgude == Udgudi
UdugKakka == Uduggaga
Uhiʾa == U₂.hi.a.KU
Ukkin == UKKIN,Unken
Ukkinuru == Unkenuru
Ulaya == Ulai
Umunirigala == Umunirigal
Umunirisaŋa == Umunirišaga
Umunirra == Umunira,Umunerra
Umunmudru == Umunmuduru
Umunŋuruša == Umunŋuruš
Umunurta == Umunuraš
Urigal == Uringal,Urugal
Urimgirizal == Urimkirizal
Urkitu == Urkittu
Urmašu == Urmašum
Urnuntaʾea == Urnuntaʾe
Usakar == Udsakar
Ušumgal == Ušumgallu
Uṣur-amassu == Uṣur-amassa,Uṣur-awassu
Uttu == Uttuk
Utu == UTU
Utulu == Utaulu,Utaʾulu

Zahgurim == Zahgurin
Zanaru == Zanarum,Zannaru
Zarpanitu == Zarpanītu
Zikarsi == Ziŋarsi
Ziqiqu == Zaqiqu
Zulum == Zuluma

